/*
 * COLEMAK
 */
 ,-----------------------------------------.                    ,-----------------------------------------.
 | TAB  |   Q  |   W  |   F  |   P  |   G  |                    |   J  |   L  |   U  |   Y  |   ;  | BSLS |
 |------+------+------+------+------+------|                    |------+------+------+------+------+------|
 | CTL  |   A  |   R  |   S  |   T  |   D  |-------.    ,-------|   H  |   N  |   E  |   I  |   O  |  '   |
 |------+------+------+------+------+------|  MUTE |    |       |------+------+------+------+------+------|
 |      |   Z  |   X  |   C  |   V  |   B  |-------|    |-------|   K  |   M  |   ,  |   .  |   /  |      |
 `-----------------------------------------/       /     \      \-----------------------------------------'
                          | ESC/ |SPACE | / CTL   /       \  SFT \  |ENTER | BSPC |
                          | NAV  | NUM  |/       /         \      \ |      |      |
                           `--------------------'           '------''-------------'

/*
 * NUM
 */
 ,-----------------------------------------.                    ,-----------------------------------------.
 |      |      |      |      |      |      |                    |      |   7  |   8  |   9  |      |      |
 |------+------+------+------+------+------|                    |------+------+------+------+------+------|
 |      |      |      |      |      |      |-------.    ,-------|      |   4  |   5  |   6  |      |      |
 |------+------+------+------+------+------|   ▼   |    |       |------+------+------+------+------+------|
 |      |      |      |      |      |      |-------|    |-------|      |   1  |   2  |   3  |      |      |
 `-----------------------------------------/       /     \      \-----------------------------------------'
                          |      |      | /   ▼   /       \  ▼   \  |      |      |
                          |      |      |/       /         \      \ |      |      |
                           `--------------------'           '------''-------------'
/*
 * SYM
 */
 ,----------------------------------------.                    ,-----------------------------------------.
 |      |      |      |      |      |      |                    |      |      |      |      |      |      |
 |------+------+------+------+------+------|                    |------+------+------+------+------+------|
 |      |      |      |      |      |      |-------.    ,-------|      |      |      |      |      |      |
 |------+------+------+------+------+------|   ▼   |    |       |------+------+------+------+------+------|
 |      |      |      |      |      |      |-------|    |-------|      |      |      |      |      |      |
 `-----------------------------------------/       /     \      \-----------------------------------------'
                          |      |      | /       /       \      \  |      |      |
                          |      |      |/       /         \      \ |      |      |
                           `--------------------'           '------''-------------'

/*
 * NAV
 */
 ,-----------------------------------------.                    ,-----------------------------------------.
 |      |      |      |      |      |      |                    |      |      |      |      |      |      |
 |------+------+------+------+------+------|                    |------+------+------+------+------+------|
 |      |      |      |      |      |      |-------.    ,-------| LEFT | DOWN |  UP  |RIGHT |      |      |
 |------+------+------+------+------+------|   ▼   |    |       |------+------+------+------+------+------|
 |      |      |      |      |      |      |-------|    |-------|      |      |      |      |      |      |
 `-----------------------------------------/       /     \      \-----------------------------------------'
                          |      |      | /       /       \      \  |      |      |
                          |      |      |/       /         \      \ |      |      |
                           `--------------------'           '------''-------------'
